Found at https://sokoban.info/?2
6 3
3
2 2
3 5
4 3
WWWWWFFFF
WFFFWWWWW
WFFFWFFFW
WFFFWFWFW
WWWFFFFFW
FWFFFWWWW
FWFFEEEWF
FWWWWWWWF
