Found at https://sokoban.info/?2
7 1
3
5 2
6 2
6 3
FWWWWWFFF
FWFFFWWWW
FWFFFWFFW
FWWFFFFEW
WWWFWWWEW
WFFFWFWEW
WFFFWFWWW
WFFFWFFFF
WWWWWFFFF
